WWWWWWWWWWWWW
W           W
W WWW WWWWWWW
W W   R     W
WWW W R WWW W
W   W R   W W
W WWWWW WWW W
W W     W   W
W W WWWWW W W
W   W R   W W
W WWW R WWW W
W     R W   W
WWWWWWWWWWWWW