WWWWWWWWWWWWW
W W         W
W W WWWWWWW W
W W W R     W
W W W R WWW W
W W   R R   W
W WWW R WWWWW
W   W R     W
W WWW WWWWW W
W   W     W W
W W W WWWWW W
W W   W     W
WWWWWWWWWWWWW